11111111
11111111
00111100
00100100
00100100
00111100
11111111
11111111

