11111111
11100111
00111100
00100100
00100100
00111100
11100111
11111111

